35 35
11111111111111111111111111111111111
10001000000000001010101010100000001
10111010101110101010101010101011111
10100010101010100000000010001000001
10111110111011111011101010101011101
10000000000000001000101000101000101
10111111111110111011111111101111101
00000010000010101000000010100000100
10111010101111101111111110111111111
10100000100000001010100000000010101
10101010111010101010101010111110101
10101010001010100000001010000000101
10101011111011101011111011111111101
10101000001000101000101010100000001
10101010101111101010101110101111111
10101010100010101010000000000010001
10101010101110101010111010111110111
10101010100000101010100010000000001
10111011111110101010101011101010111
10100000100000101010101000101010101
10101011101111111011111011101011101
10101000100010000000100010101000001
10111011111011101010111010111011101
10100000101010101010100000101000101
10101011101010111111101010101111101
10101010000000000000101010000010101
10111111101110101110111010111010111
10000010001000100010001010001000001
10101011101011111110111110111011111
10101000101000100000100000001010001
10111111101110111110111110101110101
10001010101010000010000010100000101
10101010111010111110111010101110111
10101000000000100000001010101000001
11111111111111111111111111111111111
